FhaZe - No response to pings for baron despite me spamming for 2 minutes and enemy team only haveing two dragons.
UntamedSupermacy - No repsonse to alert pings for baron. Went to gank top lane despite top being behind and mid ahead.
Neekolas - As Darius, went AFK after contributing four deaths and one kill. Name-calling in all-chat after the loss.
E Tooth Gaming - As Yasuo, fed a total of 14 kills. Kept going in with no backup and missed Qs even point blank.
Great Tempest - Garen. Lost 1 v 1 versus Irelia despite having ignite and Irelia having TP. Kept trying to fight and asking for ganks.

Simp4KimDahyun - Fed the midlane Kai Sa as Katarina then did nothing. Still moved around the map to prevent ability to remake or mitigate loss.

I am Kim Dahyun - Teemo. Fed Nasus 1-11 and still took camps for no reason. Not pre-emptive, took them while wave could be pushed. No communication.
Grêen Lantern - Original name is Gr(e^)en Lantern. Locked in Fiora despite being support. No consent from our top. Went to duo-lane top.

Sligo - As Pantheon support, went top and lost the lane. Bottom lane lost as well.

Mc 1 Mid Only - Picked Katarina as support and forced a two-champion mid.

Mr BunnyGod - Draven. Fed 5 kills bottom then went top to steal CS.

ƒaƒa G O M S - Lucian. Assigned support, forced Lucian mid. Only our hard-carry top saved us.

AI Muk - Poppy. AFK after 5 deaths, no kills.

Foohkyoh - Ezreal. Picked Ezreal as support and took CS from Aphelios.

T0UJ0U K0J0U - Banned my declared Karthus pick. Went five minutes with no items.

CIA Yamikaze - Picked Zed despite being assigned support. Gave us easy win.

Jason Terrence - Picked Ryze despite being assigned support and went midlane with their Lux. Easy no-brain win.

Mathaios JaZ Kng - Went AFK for three minutes while we had Elder. Started moving immediately after enemy reached our base just to get killed.

decktecttive - Went AFK after feeding a Fiora as Yone. Lost 2 kills early, died after my failed gank, went AFK.

IceMaKe14 - Went five levels down and gave 17 kills. No response to pings.

_co_ber - Picked Skarner mid and Fed after giving four kills. Did not want me to take his CS.

WHAMMMY - Picked Kha Zix mid, complained when he did not get ganks. Enemy Viktor had priority most of the game.

Jð ßêllê - Morgana. Intentionally went AFK for one minute to allow super minions to kill our base towers and for our Akali to die. No response to pings.

SUMMONERS XIAN - Lux. Banned my declared pick, insisted on objectives with health/power deficit.

ENGRACIAL29 - Jax. Went AFK for five minutes and did not move even after we got shutdowns during the enemy baron push.

K4nji - Rammus. This player fed at least five kills to our team after dying thrice. There were other kills by going into tower after taking damage or simply standing still an not dodging damage.

Aeòlus - As Riven, lost three kills to Jax and started roaming without pushing top. Took jungle camps and tried to gank.

qwertykit24 - As Renggar, took dragon without mid priority and with a losing bottom lane. Fed three kills. Went AFK after losing herald.

desind N ame - Lee Sin top. Spam pinged JNG after losing solo twice and once to a gank. Fed kills after that by selling items andfighting with only Doran's Rings.

Zhyan Lee - Xin Zhao. Ignored pings to stop pushing versus an MF and Thresh bot. Kept diving in against multiple enemies with no support, once during team shove of lanes to prep Baron. Name-calling and blaming in chat for his stupid deaths or lost objectives.

pusangINAnyo - Sona. Used heal with 60% health then ignite on me while I was 50% health. Roamed randomly after dying.

AM 4
PM 0

